11111111111111111111111111111111
1000000000000000000000C000000001
10000000000100C00000000000000001
1000P000000100000C0000000E000001
1000000C000100000000000000000001
11111111111111111111111111111111